++#+++++##+#++++#+++
++++##+##++#++#+#+++
++++#+#+++#++#+#+#++
+#+++++#+++#++++++++
++h+++++###+#+#++#+#
+++++#+++#++++++++++
+#+#+#++++#+++++#+++
+#++#+##+++#++++##+#
#++##+#++$+++#+++++#
+####+++++++#+++###+
++#++++++##++++++#+#
++++#+++#+++#+++#+#+
++#+++++++++++++++++
+++##+#+#+++++##+++#
#++#++++++++++++++++
+##++#+#+++#++#+++++
##+++++++++++++#++++
++++++##++++##++++##
+###++++++++#++#++#+
++++++++++++++++#+#+
